X.XXXXXXXXX
X...X...X.X
XXX.X.XXX.X
X...X.X.X.X
X.XXX.X.X.X
X.........X
X.X.X.XXX.X
X.X.X...X.X
X.XXX.XXX.X
X...X.X...X
XXXXXXXXX.X