X.XXXXXXXXXXXXXXXXXXX
X.X...........X...X.X
X.X.XXXXXXX.XXXXX.X.X
X.....X.....X.X.....X
XXX.XXXXX.X.X.X.XXX.X
X.........X...X.X...X
XXXXXXXXXXX.X.X.X.X.X
X.X.X.......X...X.X.X
X.X.X.XXX.XXXXX.X.X.X
X...X.X.....X.X...X.X
X.XXXXXXX.X.X.XXX.X.X
X...X...X.X.X.....X.X
X.X.X.XXX.X.X.XXX.X.X
X.X...X.....X.X...X.X
XXXXX.X.XXXXX.X.XXX.X
X.....X...X...X.X...X
X.X.XXX.XXXXXXX.XXXXX
X.X...X...X.....X.X.X
X.X.XXXXXXXXX.XXX.X.X
X...X...............X
XXXXXXXXXXXXXXXXXXX.X