X.XXXXXXXXX
X.....X...X
X.XXXXX.X.X
X.X.....X.X
X.X.XXXXX.X
X.X.....X.X
X.XXXXX.X.X
X.......X.X
X.XXXXXXX.X
X.X.......X
XXXXXXXXX.X