X.XXXXXXXXXXXXXXXXXXXXXXXXXXXXXXXXXXXXXXXXXXXXXXXXXXXXXXXXXXXXXXXXXXXXXXXXX
X.........................................................................X
X.........................................................................X
X.........................................................................X
X.........................................................................X
X.........................................................................X
X.........................................................................X
X.........................................................................X
X.........................................................................X
X.........................................................................X
X.........................................................................X
X.........................................................................X
X.........................................................................X
X.........................................................................X
X.........................................................................X
X.........................................................................X
X.........................................................................X
X.........................................................................X
X.........................................................................X
X.........................................................................X
X.........................................................................X
X.......XXXXXXXXXXXXXXXXXXXXXXXXXXXXXXXXXXXXXXXXXXXXXXXXXXXXXXXXXXXXXXXXXXX
X.........................................................................X
X.........................................................................X
X.........................................................................X
X.........................................................................X
XXXXXXXXXXXXXXXXXXXXXXXXXXXXXXXXXXXXXXXXXXXXXXXXXXXXXXXXXXXXXXXXXXXXXXXXX.X