X.XXXXXXXXXXXXXXXXXXX
X...............X...X
X.XXXXX.XXXXXXXXX.X.X
X...X...X.........X.X
XXXXX.XXX.XXXXXXXXXXX
X...X.X...X.........X
X.X.X.X.XXXXXXXXXXX.X
X.X...X...X.........X
X.XXXXXXX.X.XXXXXXX.X
X.X.......X.X.......X
X.X.XXXXXXX.XXXXX.XXX
X.X...X.........X.X.X
X.XXX.XXXXX.XXX.X.X.X
X...X.....X...X.X...X
X.X.XXXXX.XXXXX.XXX.X
X.X.......X.....X...X
X.XXXXXXXXX.XXXXX.XXX
X.X.......X...X...X.X
X.XXXXX.X.XXX.X.XXX.X
X.......X.....X.....X
XXXXXXXXXXXXXXXXXXX.X